     695 Recovery/standards/core-standards/complexity-scoring-framework.md	Recovery/standards/core-standards/complexity-scoring-framework.md
     671 Recovery/standards/core-standards/simplicity-principles.md	Recovery/standards/core-standards/simplicity-principles.md
     555 Recovery/standards/archive-standards/claude-code-compact-communication-standards.md	Recovery/standards/archive-standards/claude-code-compact-communication-standards.md
     446 Recovery/standards/compliance-standards/execution-integration-standards.md	Recovery/standards/compliance-standards/execution-integration-standards.md
     426 Recovery/standards/core-standards/web-vitals-standards.md	Recovery/standards/core-standards/web-vitals-standards.md
     364 Recovery/standards/compliance-standards/tool-call-execution-standards.md	Recovery/standards/compliance-standards/tool-call-execution-standards.md
     355 Recovery/standards/core-standards/orchestration-standards.md	Recovery/standards/core-standards/orchestration-standards.md
     327 Recovery/standards/compliance-standards/writing-standards-integration.md	Recovery/standards/compliance-standards/writing-standards-integration.md
     265 Recovery/standards/compliance-standards/clarity-communication-standards.md	Recovery/standards/compliance-standards/clarity-communication-standards.md
     261 Recovery/standards/archive-standards/compact-notification-standards.md	Recovery/standards/archive-standards/compact-notification-standards.md
     257 Recovery/standards/core-standards/quality-improvement-standards.md	Recovery/standards/core-standards/quality-improvement-standards.md
     233 Recovery/standards/compliance-standards/core-writing-structure-standards.md	Recovery/standards/compliance-standards/core-writing-structure-standards.md
     219 Recovery/standards/core-standards/command-standards.md	Recovery/standards/core-standards/command-standards.md
     219 Recovery/standards/compliance-standards/context-engineering-core-standards.md	Recovery/standards/compliance-standards/context-engineering-core-standards.md
     210 Recovery/standards/core-standards/writing-standards-archive.md	Recovery/standards/core-standards/writing-standards-archive.md
     193 Recovery/standards/core-standards/content-organization-standards.md	Recovery/standards/core-standards/content-organization-standards.md
     178 Recovery/standards/methodology-standards/ppo-fmea-standardization.md	Recovery/standards/methodology-standards/ppo-fmea-standardization.md
     171 Recovery/standards/core-standards/technical-standards-hub.md	Recovery/standards/core-standards/technical-standards-hub.md
     122 Recovery/standards/core-standards/technical-standards.md	Recovery/standards/core-standards/technical-standards.md
     102 Recovery/standards/core-standards/documentation-standards.md	Recovery/standards/core-standards/documentation-standards.md
      78 Recovery/standards/compliance-standards/writing-standards-rules.md	Recovery/standards/compliance-standards/writing-standards-rules.md
      57 Recovery/standards/core-standards/document-template.md	Recovery/standards/core-standards/document-template.md
